
NO ./textures/nw.png



SO ./textures/sw.png






EA                                        ./textures/ew.png
F       0,0,0



C                         146,239,243


WE ./textures/ww.png







        1111111111111111111111111
        1000000000110000000000001
        1011000001110000040000001
        1002000000000000000000001
111111111011000001110000000000001
        1011000001110000000000001
        1002000000000000000000001
1111111110110000011100000N0000001
100000000110000011101111111111111
11110111111111011100000010001
11110111111111011101010014001
11000000110101011100000010001
10000000000000001100000010001
10000000000000041101010010001
1100000111010101111101111000111
11110111 1110101 101111010001
11111111 1111111 111111111111
